NO textures/bricks/brick_purple.png
SO textures/bricks/brick_red.png
WE textures/bricks/brick_orange.png
EA textures/bricks/brick_green.png
F 225, 0, 0
C 135, 206, 125
111111111111111111111111111111111111111111111111111111111
100000110000100010101100000001000000101000000000000100101
110000010011000010100000000010000100110010010000010101001
101110010000100010000010000000100110101000000000111001111
101000100011001000100000010001000000000000010010000000001
101000010110000000000000000000101110000000100000101100101
100000101010000000100101000000010000000000000000010010111
100010000000010100011100000100001101000000000000000100011
100111001100000010100001000111000111110011000111100010011
100110000000000001000000000010011100000001011010000001001
100010010001000000000010010110101001010100000010000001101
101001001110000000100000001000010000110010W10111000100011
101010010100110000000001000010001111001011010100100000101
100010011101001000001100000101010010100100000010010001001
101001000001011101100110000000100100000100010000000100001
111111111111111111111111111111111111111111111111111111111