NO textures/bricks/brick_purple.png
SO textures/bricks/brick_red.png
WE textures/bricks/brick_orange.png
EA textures/bricks/brick_green.png
F 225, 0, 0
C 135, 206, 125
111111111111111111111111111111111
100000001001000010000050000100001
100010101110000000101001001100001
1010E0010005110000005001001000101
100001000000110101000000010010001
100001100010010100100000010010101
100000000111001001001000001111001
110050001001111100000011000000001
100000010110000000101000011111101
111000100100011001010000101010001
100100100110000001100010005000011
111111111111111111111111111111111