NO textures/bricks/brick_purple.png
SO textures/bricks/brick_red.png
WE textures/bricks/brick_orange.png
EA textures/bricks/brick_green.png
F 225, 0, 0
C 135, 206, 125
111111111111111111111111111
1005010011000100001000W1001
110010001000000000110000501
100001111000000010010000001
100001100000000005000000001
110100110000000100010001001
100000000001000000000001001
111100000010000000000011101
100000100000100010000000001
111000010000001101100000111
110110001001100011000100001
100000001000000100100000011
100000101100000000000000001
101001000001000010000000001
110000000001000100001001111
100011110000000001000000001
101000000001000010000100001
111111111111111111111111111