NO textures/bricks/brick_purple.png
SO textures/bricks/brick_red.png
WE textures/bricks/brick_orange.png
EA textures/bricks/brick_green.png
F     225		,   0,   0
C 		135		,   206,   125
111111111111111111111111111111
111000010100000000000100001001
100000100101110000010000100001
101010001110000011500001000001
101050001000110001001000001001
100000000101000010000000000001
100001100100000000100100000001
100111010000000E10010000001001
111100000001000001000000000011
100000001000000100000000100101
101010000000000001111001000101
100110110000100010010011101001
100001100100011000000000001001
100015000010001100110000010111
111111111111111111111111111111
