NO textures/bricks/brick_purple.png
SO textures/bricks/brick_red.png
WE textures/bricks/brick_orange.png
EA textures/bricks/brick_green.png
F 225, 0, 0
C 135, 206, 125
111111111111111111111111111
101000010000110010000000101
110000000000000010000000011
105001000000000000000101101
110010000110010001100511001
10E000001110100000001000001
100001000000511000000000001
110010000100010010111000011
100010000000100010000000001
100000100000000001100000001
110000000001101011110000101
110100100001100011110000101
100000000001110000011001001
111111111111111111111111111