NO textures/bricks/brick_purple.png
SO textures/bricks/brick_red.png
WE textures/bricks/brick_orange.png
EA textures/bricks/brick_green.png
F 225, 0, 0
C 135, 206, 125
11111111111111
10000000000011
11010010110011
11000000000001
10000000000001
10110000011011
10000000001101
10000100000101
11000100000001
10100011100101
10100N10000101
10000100001001
10010000100101
10000111100101
10110000000001
10010110001001
11111111111111