NO textures/bricks/brick_purple.png
SO textures/bricks/brick_red.png
WE textures/bricks/brick_orange.png
EA textures/bricks/brick_green.png
F 225, 0, 0
C 135, 206, 125
111111111111
100100000101
100100000101
100101000011
110000100001
110000000011
110001000001
111011001001
101000101001
10101N010101
101011001101
111000000101
110010010001
111010000101
100001001111
101000010001
101101000011
100011010101
100000010111
111111111111