NO textures/bricks/brick_purple.png
SO textures/bricks/brick_red.png
WE textures/bricks/brick_orange.png
EA textures/bricks/brick_green.png
F 225, 0, 0
C 135, 206, 125
111111111111111111111111111
100000010100110000101110011
100000105001000100010100111
100001011101010101101001111
111010000000000001000001001
100000110050010000000000001
110010000001001111010000001
100000001100000100W00011101
100100010100010000001000011
100011510000100010100011011
110000100011000100011011011
111100010000011000110010101
100100000100100011101010001
110000100000000010000000101
100000000010001101000001011
101100011000110001000100001
100100110010101000000101001
100001051001001000001000101
111111111111111111111111111