NO textures/bricks/brick_purple.png
SO textures/bricks/brick_red.png
WE textures/bricks/brick_orange.png
EA textures/bricks/brick_green.png
F 225, 0, 0
C 135, 206, 125
111111111111111111111111111111
101000001100111001010000000101
100000011110000000000001001101
100010100000110000500000010001
100000000100010000100000005011
101100100100001000100100000001
100011000000010010100011010001
100000000000001000001100000111
100110100015000000001000000001
100000000000001001000155000101
10000110N000000011101100010011
100000010000000110000001000001
111111111111111111111111111111