NO textures/bricks/brick_purple.png
SO textures/bricks/brick_red.png
WE textures/bricks/brick_orange.png
EA textures/bricks/brick_green.png
F 225, 0, 0
C 135, 206, 125
11111111111111111111111
10000000000000000101001
10101010100000000010001
10101001000100001000101
10000100000011000101001
10010001000010011111001
11100000000000010100001
10101000100100011000001
1E010000001000100010001
11111111111111111111111