NO textures/bricks/brick_purple.png
SO textures/bricks/brick_red.png
WE textures/bricks/brick_orange.png
EA textures/bricks/brick_green.png
F 225, 0, 0
C 135, 206, 125
11111111111111111111111111
10150001100000000000000001
11100000100110100000001101
10000100100100100010000001
11101000005000000110100101
11000000000000000010101101
10001015101000000100000011
10000000100100100000001101
10100101051000100000000001
10000001000001000010001001
1000000000100E000000101101
11100000001110000000110011
11000100001001100000100051
10000010000000011010001111
10000100100110010000110101
11010110000000000000010001
10001000000000000000001001
10111010110101000000000101
11010101000001005010000101
11111111111111111111111111






