NO textures/bricks/brick_purple.png
SO textures/bricks/brick_red.png
WE textures/bricks/brick_orange.png
EA textures/bricks/brick_green.png
F 225, 0, 0
C 135, 206, 125
1111111111
1000101001
1100100001
1000010111
1000110001
1011101101
1100111011
1105010001
1001000001
1010100001
10000E1001
1101000111
1001000111
1110100001
1001010001
1011000001
1000100001
1000000001
1000011001
1111111111






