NO textures/bricks/brick_purple.png
SO textures/bricks/brick_red.png
WE textures/bricks/brick_orange.png
EA textures/bricks/brick_green.png
F 225, 0, 0
C 135, 206, 125
111111111111111111111111
100001000110000000000001
111001000010101010000101
111100000000000000000101
100000001010100000001001
100000000010001100010001
100000000111101000100101
101001000000010000000111
110000011000100001000101
10000101N000100011101101
100001000011001000010101
101000001000000001000001
101101000000000001000101
100000000110000000010001
100001110000000101110111
100000010001001000001011
111111111111111111111111