NO textures/bricks/brick_purple.png
SO textures/bricks/brick_red.png
WE textures/bricks/brick_orange.png
EA textures/bricks/brick_green.png
F 225, 0, 0
C 135, 206, 125
111111111111111111111
100010000100100100001
100000101000010001011
100000011010101000001
105000000000000000101
100101010001001010101
100000005001011000001
110010000001000100011
100001000000000010001
110010000001001000101
100100000000001100001
101000000010005000011
10000000000N000101011
100000100000000000011
100100101010051000001
110000010100001000011
111111111111111111111