NO textures/bricks/brick_purple.png
SO textures/bricks/brick_red.png
WE textures/bricks/brick_orange.png
EA textures/bricks/brick_green.png
F 225, 0, 0
C 135, 206, 125
1111111111111111111
1010000000100100001
1000100110100000101
1000110000000000101
100E110001010100001
1000000000000111001
1000000001001000101
1000001000001000011
1001000100110100001
1010000010001000001
1100000010100010101
1001010110000010001
1010000050100100011
1000010000100010001
1000000500100001001
1000000000010100011
1100001000110100011
1010000000010101011
1111111111111111111