NO textures/bricks/brick_purple.png
SO textures/bricks/brick_red.png
WE textures/bricks/brick_orange.png
EA textures/bricks/brick_green.png
F 225, 0, 0
C 135, 206, 125
111111111111111111111
100010000000100000101
100100000001000000111
110501001001000001011
110000110000100000101
100001100000000100011
101110100001000100101
100001101000001000101
1101000000000100W1011
101100011100000000011
100000000100010001001
100010000001001000001
110010100000000000011
100010000000010001001
110100111000010010001
111111111111111111111