NO textures/bricks/brick_purple.png
SO textures/bricks/brick_red.png
WE textures/bricks/brick_orange.png
EA textures/bricks/brick_green.png
F 225, 0, 0
C 135, 206, 125
111111111111111111111111111111111111
111000110011100000100111110051110101
100011000001110000001000000101001011
101010001100105000000000010000001001
100000000010001000000101000000000101
1101010000011010150001W0000100110001
100000000000000001010000001010000011
100000011000000000010100000001111101
110000010010010010010011000101101101
100110110010000000000101000000000001
100010510100001010000000000001010001
100000000011005001000001011000100001
100001011101000000110001010010010101
100000000100100111100000000101000001
110100101010010001100000100000011011
111000010011050000100010000000000111
111111111111111111111111111111111111