SO  textures/bricks/brick_red.png
WE   textures/bricks/brick_orange.png
EA       textures/bricks/brick_green.png
NO    textures/bricks/brick_purple.png

C  135   ,   206,    125
F     225,   0,    0


                                              11      111111
                                             10011   10000001
                                             100001  1010000111
                                   1111  1  1000101 100111100001
                               11 10000110110000001100011  10001
                             11001101000001 10000111010001 11001
                            100000000100001110000001000001100001
                             10000010100010010111001010100000001
                            110000000000000011100011110000000001
                           1000000000000000000100000000000000001
                          10000100000000000000001001101000000001
                          100000E000000000000001 11  11000000001
                           1100000000000000001001      101000001
                             1010000000000100000111    100000001
                             10000100000000100001001   10000001
                            100000000000000000000001    1000101
                             1111100000000000010001     10000001
                                 10000000000001111       1000001
                                 1000000000001            100001
                                  11111111111              1111