
NO 	     textures/bricks/brick_purple.png

SO 		textures/bricks/brick_red.png

WE  textures/bricks/brick_orange.png

EA       textures/bricks/brick_green.png


F    138  ,   138  ,      138

C 	 135	 ,   206,   235


11111111111111111  11111111111111
100001000000000011110000000000001111111
100005000000000001100000000011100000001
111111000000010000000000000010500000009
100000000000101000000000000010100000001
10000000000001000E000000000010100000001
100111000000010000001111111119111111111
101000100000100000001000001
101000500000100000005000001
101000100000100000001111111
111151111111111111111
100000000000000000001
111110000000000000009
    11111111111111111