SO  textures/bricks/brick_red.png
WE   textures/bricks/brick_orange.png
EA       textures/bricks/brick_green.png
NO    textures/bricks/brick_purple.png

C  135   ,   206,    125
F     225,   0,    0


   11111111111111  11111111111111
111001000000000011110000000000001111111
100000000000000001100000000011100000001
111111000000010000000000000010000000001
100000000000111000000000000010100000001
10000000000001000N000000000010100000001
100111000000010000001111111111111111111
101000100000110000001000001
101000000000100000000000001
101000100000100000001111111
111101111111111111111
100000000000000000001
111110000000000000001
    11111111111111111