
NO 	     textures/bricks/brick_purple.png

SO 		textures/bricks/brick_red.png

WE  textures/bricks/brick_orange.png

EA       textures/bricks/brick_green.png

F 189,160,69

C 128,128,223


        1111111111111111111111111
        1000000000110000000000001
        1011000001110000000000001
        1001000000500000000000001
111111111511000001110000000000001
100000000011000001115111111111111
11110111111111011100000010001
11115111111111511101010010001
11000000110101011100000010001
10000000000000001100000010001
10000000000000001101010010001
11000001110151011101011510N01
11110111 1110101 101111000001
11111111 1111111 111111111111