
NO 	     textures/bricks/brick_purple.png

SO 		textures/bricks/brick_red.png

WE  textures/bricks/brick_orange.png

EA       textures/bricks/brick_green.png


F     225	 ,   0,   0

C 	 135	 ,   206,   125


11111
10000
11111