111111111111111111111111111111111111111
100001000000000011110000000000000000001
100005000000000001100000000011100000001
111111000000000000000000000050100000009
10000E000000000000000000000011100000001
100000000000000000000000000000000000001
100111000000010000001111111111111111111
101000100000100000001000001
101000500000100000005000001
101000100000100000001111111
111151111111111111111
100000000000000000001
100000000000000000009
111111111111111111111