111111111111111111111
100000000000000000001
10P000001010000000001
100000000100000000001
100000000000000000001
101100100000100000001
101100100000111111001
101100100000001001001
101100100000000000001
100100111111111110001
100000000000000000001
100000000000000000001
111111111111111111111