11111111111111111
10000000000000001
10P00000000000001
10000000000000001
10000000000000001
10010010000000001
10010010000000001
10010010000000001
10010010000000001
10010011111111111
10010000000000001
10010000000000001
11111111111111111