111111111111111111111
100000000000000000001
10P000000100000000001
100000000000000000001
100000000000000000001
100100100000000000001
100100100000000000001
100100100000000000001
100100100000000000001
100100111111111110001
100000000000000000001
100000000000000000001
111111111111111111111