111911111111111111111
100000000000000000001
100000001010000000001
1000E0000100000000001
100000000500000000001
101500500100100000001
101100100000111111001
101100100000001001001
101100100000000000001
100100111191111110001
100000000000000000001
100000000000000000001
111111111111111111111