111111111111111111111111111111111111111111
10000000000000000000000P000000000000000001
100000001010000000000000000000000000000001
100000000100000100000000000000010000000001
100000000000000000000000000000000000000001
101100100000100000000000000100000000000001
101100100000111111000000000000000000000001
101100100000001001000000000000000000000001
101100100000000000000000000000000000000001
100100111111111110000000000000000000000001
100000000000000000000000000000000000000001
100000000000000000000000000000000000000001
100000000000000000000000000000000000000001
100000000000000000000000000000000000000001
100000000000000000000000000000000000000001
100000000000000000000000000000000000000001
100000000000000000000000000000000000000001
100000000000000000000000000000000000000001
100000000000000000000000000000000000000001
100000000000000000000000000000000000000001
111111111111111111111111111111111111111111