
NO textures/Tiles.png

SO textures/bluestone.png

WE textures/green.png

EA textures/black.png


F 189,160,69

C 128,128,223


111111111111111111111111111111111111111111
1000000000000000000000E0000000000000000001
100000001010000000000000000000000000000001
100000000100000100000000000000010000000001
111111111111111111111111111111111111111111