
NO 	     textures/bricks/brick_purple.png

SO 		textures/bricks/brick_red.png

WE  textures/bricks/brick_orange.png

EA       textures/bricks/brick_green.png


F    138  ,   138  ,      138

C 	 135	 ,   206,   235


111111111111111111111111111111111111111111
1000000000000000000000E0000000000000000001
100000001010000000000000000000000000000001
100000000100000100000000000000010000000001
111111111111111111111111111111111111111111