
NO 	     textures/brick.png

SO 		textures/brick.png

WE  textures/brick.png

EA       textures/brick.png


F    138  ,   138  ,      138

C 	 135	 ,   206,   235

11111111
10000001
10000001
11000E01
10000001
10000001
11111111